11111111111111111111
100P0000001010100001
11100100100000000001
1000000000C011100001
111001001010111110E1
11111111111111111111
