1111111111111111111111111111
1000100000000000000000000001
1000111000000011111000000001
10000000E0000010000000000001
10000C0000C0P000000000000001
1000000000001110001000000001
1111111111111111111111111111