1111111111111111111111111111
1E0010C000000000000000000001
1000111000000011111000000001
1000000000000010C01000000001
100000000P000001001011000001
100C0000000011100010C1000001
1111111111111111111111111111